---------------------------------------------------------------------------------oo----X-oo------oo----X-oo----------------------------------oo--oo------oo---------------------------------------------
--------------------------------------------------------------------------------o--o--XXo--o----o--o--XXo--o--------------------------------o--oo--o----o--o--------------------------------------------
-------------------------------------------------------------------------------------XXX-------------XXX------------------------------------------------------------------------------------------------
--------------------------------------------------------------------------------X--XXXXXX--X----X--XXXXXX--X--------------------------------X--XX--X----X--X--------------------------------------------
-----oo------oo------oo----------oo------oo--------X-oo------oo----------oo------------------oo------oo----------------------oo--oo--E---oo----X-----oo------oo--------X-oo---B------oo-----------------
----o--o----o--o----o--o--------o--o----o--o--E---XXo--o----o--o--------o--o----------------o--o----o--o--------------------o--oo--oB?M?o--o--XX----o--o----o--o------XXo--o--------o--o----------------
-------------------------------------------------XXX-----------------------------------------------------------------------------------------XXX---------------------XXX--------------------------------
----X--X----X--X----X--X--------X--X----X--XXXXXXXXXX--X----X--X--------X--X----------------X--X----X--X--------------------X--XX--X----X--XXXXX----X--X----X--X----XXXXX--XXXXX----X--X---------------v
---------oo------oo------oo--oo------oo------------------oo--------------oo------oo------oo------oo------oo--------------------------------------oo------oo------oo--oo----------oo------oo------oo----f
--------o--o----o--o----o--oo--o----o--o----------------o--o------------o--o----o--o----o--o----o--o----o--o------------------------------------o--o----o--o----o--oo--o--------o--o----o--o----o--o---f
-------------------------------------------------------------------------------------------------------------------------------------------------------------------------------------------------------f
--------X--X----X--X----X--XX--X----X--X----------------X--X------------X--X----X--X----X--X----X--X----X--X------------------------------------X--X----X--X----X--XX--X--------X--X----X--X----X--X---f
-oo--------X-oo------oo--------X-oo------E---oo--T---oo------oo--T---oo----X-oo--------X-----oo------oo--oo--T---E---T---E-----X-oo--E---oo--------X-oo------oo--------X-oo--T---oo--oo------oo------oof
o--o--E---XXo--o--E-o--o--E---XXo--o--E-B?M?o--o-|oTo--o--E-o--o-|oTo--o--XXo--o--E---XX--E-o--o--E-o--oo--o-|oTB?M?-|oTB?M?--XXo--oB?M?o--o--E---XXo--o--E-o--o--E---XXo--o-|oTo--oo--o--E-o--o--E-o--f
m--------XXX-----------------XXX-----------------|-|-------------|-|-----XXX---------XXX---------------------|-|-----|-|-----XXX-----------------XXX-----------------XXX-----|-|-----------------------X
XX-XXXXXXXXXX--XXXXXX--XXXXXXXXXX--XXXXX----X--XXXXXX--XXXXXX--XXXXXX--XXXXXX--XXXXXXXXXXXXXX--XXXXXX--XX--XXXXX----XXXX----XXXXX--X----X--XXXXXXXXXX--XXXXXX--XXXXXXXXXX--XXXXXX--XX--XXXXXX--XXXXXX--X
