-oo-----Boo?Boo?-----------------E------Boo?-----E-------E------Boo?-E---oo-Boo?-oo-Boo?-oo------oo----------------------------------E--Boo?-------------E---oo--------------E---------X-oo--------XBoo?
o--o----o-Moo-Mo----------------B?M?----o-Mo----B?M?----B?M?----o-MoB?M?o--oo-Moo--oo-Moo--o----o--o--------------------------------B?M?o-Mo------------B?M?o--o------------B?M?------XXo--o------XXo-Mo
---------X---X---------------------------X-----------------------X-----------X-------X---------------------------------------------------X-------------------------------------------XXX---------XXX-X--
X--X--------------------------------------------------------------------X--X----X--X----X--X----X--X--------------------------------------------------------X--X--------------------XXXXX--X----XXXX----
Boo?----Boo?-----oo--oo------E------Boo?-----E---------------oo--oo-Boo?---XBoo?-----E---------------oo---------Boo?----Boo?----Boo?-------------------X--------Boo?---------E---oo-Boo?Boo?-oo---------
o-Mo----o-Mo----o--oo--o----B?M?----o-Mo----B?M?------------o--oo--oo-Mo--XXo-Mo----B?M?------------o--o--------o-Mo--E-o-Mo----o-Mo------------------XX--------o-Mo--------B?M?o--oo-Moo-Moo--o--------
-X-------X---------------------------X-------------------------------X---XXX-X-----------------------------------X-------X-------X-------------------XXX---------X-------------------X---X--------------
----------------X--XX--X------------------------------------X--XX--X----XXXX------------------------X--X------------XXXX----------------------------XXXX------------------------X--X--------X--X-------v
Boo?-E--Boo?-E-------oo-Boo?-E---oo--E---oo-----Boo?-----oo----X-oo--oo--E-------E-------E-------E--Boo?-E------Boo?-----oo-----Boo?-E--------------Boo?Boo?-E-------T-------E------Boo?---------E-----f
o-MoB?M?o-MoB?M?----o--oo-MoB?M?o--oB?M?o--o----o-Mo----o--o--XXo--oo--oB?M?----B?M?----B?M?----B?M?o-MoB?M?----o-Mo----o--o----o-MoB?M?------------o-Moo-MoB?M?-----|oT----B?M?----o-Mo------E-B?M?---f
-X-------X---------------X-----------------------X-----------XXX-------------------------------------X-----------X---------------X-------------------X---X-----------|-|-------------X-----------------f
--------------------X--X--------X--X----X--X------------X--XXXXXX--XX--X------------------------------------------------X--X----------------------------------------XXXX--------------------XXXX-------f
-oo------oo--------X-----E---oo----X-------X-oo------T-------T--Boo?-E-------E-------E-------E-------oo------E-------T---E---E---oo------oo------oo------T-------oo------T---------X-----oo--T---------f
o--o--E-o--o--E---XX--E-B?M?o--o--XX--E---XXo--o--E--|oT--E--|oTo-MoB?M?--E-B?M?--E-B?M?--E-B?M?--E-o--o--E-B?M?--E--|oTB?M?B?M?o--o--E-o--o--E-o--o--E--|oT--E-o--o--E--|oT--E---XX--E-o--o-|oT--E---Xf
m----------------XXX-------------XXX-----XXX---------|-|-----|-|-X---------------------------------------------------|-|---------------------------------|-|-------------|-|-----XXX---------|-|-----XXX
XX-XXXXXX--XXXXXXXXXXXXX----X--XXXXXXXXXXXXXX--XXXXXXXXXXXXXXXXX--------XXXX----XXXX----XXXX----XXXXX--XXXXX----XXXXXXXX--------X--XXXXXX--XXXXXX--XXXXXXXXXXXXXX--XXXXXXXXXXXXXXXXXXXXXX--XXXXXXXXXXXXX
