-------------------------------------------------------------------------oo------oo----------oo----------oo--oo--------------------------------------oo------oo-----------------------------------------
------------------------------------------------------------------------o--o----o--o--------o--o--------o--oo--o------------------------------------o--o----o--o----------------------------------------
--------------------------------------------------------------------------------------------------------------------------------------------------------------------------------------------------------
------------------------------------------------------------------------X--X----X--X--------X--X--------X--XX--X------------------------------------X--X----X--X----------------------------------------
-----oo----X-oo--oo--oo------oo----------oo--oo----------oo----------------------oo----X-oo----------------------oo----X-oo------oo------oo------------X-oo------oo----------oo--oo----------oo------oo-
----o--o--XXo--oo--oo--o----o--o--------o--oo--o--------o--o--------------------o--o--XXo--o--------------------o--o--XXo--o----o--o----o--o----------XXo--o----o--o--------o--oo--o------E-o--o----o--o
---------XXX-------------------------------------------------------------------------XXX-----------------------------XXX-----------------------------XXX------------------------------------------------
----X--XXXXXX--XX--XX--X----X--X--------X--XX--X--------X--X--------------------X--XXXXXX--X--------------------X--XXXXXX--X----X--X----X--X--------XXXXX--X----X--X--------X--XX--X----XXXXX--X----X--v
---------oo--------X-----oo------oo--------------oo--T-------oo--oo--E---oo------oo----------oo------oo------oo--------------oo------oo--------------oo------oo------oo--oo--------X-oo----------oo----f
--------o--o------XX----o--o----o--o------------o--o-|oT----o--oo--oB?M?o--o----o--o--------o--o----o--o----o--o------------o--o--E-o--o------------o--o----o--o----o--oo--o------XXo--o--------o--o---f
-----------------XXX---------------------------------|-|-------------------------------------------------------------------------------------------------------------------------XXX-------------------f
--------X--X----XXXX----X--X----X--X------------X--XXXXX----X--XX--X----X--X----X--X--------X--X----X--X----X--X------------X--XXXXXX--X------------X--X----X--X----X--XX--X----XXXXX--X--------X--X---f
-E---oo----X-oo----X-oo------oo------oo--T---oo------T---oo--------X-T-------oo------oo--T-------oo--E---T---oo--oo--T---oo------oo------oo------oo------oo------oo--------X-oo----X-oo--T---oo----X-oof
B?M?o--o--XXo--o--XXo--o--E-o--o--E-o--o-|oTo--o--E--|oTo--o--E---XX-|oT--E-o--o--E-o--o-|oT--E-o--oB?M?-|oTo--oo--o-|oTo--o--E-o--o--E-o--o--E-o--o--E-o--o--E-o--o--E---XXo--o--XXo--o-|oTo--o--XXo--f
m--------XXX-----XXX---------------------|-|---------|-|---------XXX-|-|-----------------|-|-------------|-|---------|-|-------------------------------------------------XXX-----XXX-----|-|-----XXX---X
XX--X--XXXXXX--XXXXXX--XXXXXX--XXXXXX--XXXXXX--XXXXXXXXXX--XXXXXXXXXXXXXXXXXX--XXXXXX--XXXXXXXXXX--X----XXXXX--XX--XXXXXX--XXXXXX--XXXXXX--XXXXXX--XXXXXX--XXXXXX--XXXXXXXXXX--XXXXXX--XXXXXX--XXXXXX--X
