-------------------------------------------------------------------------oo----------------------------------------------------------------------oo--------------oo------oo------------------oo--oo-----
------------------------------------------------------------------------o--o--------------------------------------------------------------------o--o--E---------o--o----o--o----------------o--oo--o----
--------------------------------------------------------------------------------------------------------------------------------------------------------------------------------------------------------
------------------------------------------------------------------------X--X--------------------------------------------------------------------X--XXXXX--------X--X----X--X----------------X--XX--X----
-oo------oo------oo------oo--E---oo--------------oo----------oo--------------oo--oo------oo------oo--E-------oo------oo------oo------oo------oo------oo--oo----X-----oo------oo------oo----------oo-----
o--o----o--o----o--o----o--oB?M?o--o------------o--o--------o--o------------o--oo--o----o--o----o--oB?M?----o--o----o--o----o--o----o--o----o--o----o--oo--o--XX----o--o----o--o----o--o--------o--o----
-------------------------------------------------------------------------------------------------------------------------------------------------------------XXX----------------------------------------
X--X----X--X----X--X----X--X----X--X------------X--X--------X--X------------X--XX--X----X--X----X--X--------X--X----X--X----X--X----X--X----X--X----X--XX--XXXXX----X--X----X--X----X--X--------X--X---v
-----oo--oo----------oo------oo------oo------oo------oo----------oo--oo--oo----X-----oo------oo------------------oo------oo--------------oo------oo----X-----oo--oo------oo--------------oo----------oof
----o--oo--o--------o--o----o--o----o--o----o--o----o--o------E-o--oo--oo--o--XX----o--o----o--o----------------o--o----o--o------------o--o----o--o--XX----o--oo--o----o--o------------o--o--------o--f
-----------------------------------------------------------------------------XXX---------------------------------------------------------------------XXX-----------------------------------------------f
----X--XX--X--------X--X----X--X----X--X----X--X----X--X----XXXXX--XX--XX--XXXXX----X--X----X--X----------------X--X----X--X------------X--X----X--XXXXX----X--XX--X----X--X------------X--X--------X--f
-oo--T-------T---oo------oo----X-oo------oo------oo------T---E---------X-----oo--oo------oo--------X-oo--E---oo------oo------E---T---E-------oo------E---oo----X-----oo------oo------oo------T---oo----f
o--o-|oT--E--|oTo--o--E-o--o--XXo--o--E-o--o--E-o--o--E--|oTB?M?--E---XX--E-o--oo--o--E-o--o--E---XXo--oB?M?o--o--E-o--o--E-B?M?-|oTB?M?--E-o--o--E-B?M?o--o--XX--E-o--o--E-o--o--E-o--o--E--|oTo--o--Ef
m----|-|-----|-|-------------XXX-------------------------|-|---------XXX-------------------------XXX-----------------------------|-|-------------------------XXX-----------------------------|-|-------X
XX-XXXXXXXXXXXXXX--XXXXXX--XXXXXX--XXXXXX--XXXXXX--XXXXXXXXX----XXXXXXXXXXXXX--XX--XXXXXX--XXXXXXXXXX--X----X--XXXXXX--XXXXX----XXXX----XXXXX--XXXXX----X--XXXXXXXXXX--XXXXXX--XXXXXX--XXXXXXXXXX--XXXXX
