-----------------------------------------------------------o-----------------------------------------------------BBBBBBBB-------------------------------???---------------------------------------------
-----------------o------------------------------------------------------------------------------------------BBBBBB--------------------------------------------------------------------------------------
-----------------------X-------M-----------------------------------?------------------------------------------------------------------------------------------------------------------------------------
-------------------------------------------------------------------------------------------------------------------------------------?------------------------------------------------------------------
-------------------------------------------------------X--M---------------------------------------------X----------------------------------------------------------------X------------------------------
----------------------?-------------------------------XX-------------XX------B-----------------------------o---XXXXXXXX-----------X-------------------------------------XX------------------------------
----------------------------------X------------------XXX-----------------X-------------------------------------------------------XX---------------------X--------------XXX------------------------------
-----------------------------M----------------------XXXX-----------------XXXoXXXX-----------????????-------XXXXXX---------------XXX-----------------------------------XXXX-----------------------------v
---------------------------------------------------XXXXX------------------------B----------BB----------------------------------XXXX---------------------------------XXXXXX-----------------------------f
-----------------------------------------M--------XXXXXX---M------------------------------------------B-----------------o-----XXXXXBBBBBBB-------------------------XXXXXXX-----------------------------f
--------M---X---------XBBBBB--X------------------XXXXXXX-----------------------------?????-----------------o-----------------XXXXXX-------------------------------XXXXXXXX-----------------------------f
---------------------XX-----------oo------------XXXXXXXX---------------------------X----------------------------------------XXXXXXX-??---------------------------XXXXXXXXX-----------------------------f
----------------T---XXX------------------------XXXXXXXXX---------T----------------XX-----X--------B------------------------XXXXTXXX-----------------------------XXXXXXXXXT------T----------------------f
----------------|--XXXX---T-------------T-----XXXXXXXXXX--T------|T----XXXXXXX---XXX----XX--------------------------------XXXXX|XXX-------------T--------T-----XXXXXXXXXX|------|----------------------f
m-EX---E--------|-XXXXX---|---M---------|----XXXXXXXXXXXE-|---E-E||-----??o???X?XXXX---XXX------------------E--E---------XXXXXX|XXX-------------|--------|----XXXXXXXXXXX|------|-----E----------------X
XXXXXXXXXXXXXXXX|XXXXXXXXX|XXXX-XXX-XXXX|XXXXXXXXXXXXXXXX-|XXXXXX||XX-XXX--XXXXXXXXXX-XXXX--XXXXXXXXXX--XXXXXXX--XXXXXXXXXXXXXX|XXXXXXXXXXXXXXXX|XXXXXXXX|XXXXXXXXXXXXXXX|XXXXXX|XXXXXXXXXXXXXXXXXXXXXXX
