-------------E-----------oo--T---E---oo?-------------------------oo?---------oo?-----oo------oo?-----------------oo?-oo------E---T---E-------E-------------------------------------------oo?------------
------------B?M?--------o--o-|oTB?M?o?M-------------------------o?M---------o?M-----o--o----o?M-----------------o?M-o--o----B?M?-|oTB?M?----B?M?----------------------------------------o?M-------------
-----------------------------|-|-----o-B-------------------------o-B---------o-B-------------o-B-----------------o-B-------------|-|-----------------------------------------------------o-B------------
------------------------X--XXXXX----------------------------------------------------X--X----------------------------X--X--------XXXX--------------------------------------------------------------------
-------X-E---------------oo?---------oo?-oo?-E---------------oo-----BBBB---------oo------oo----------oo?-E-----------oo----------oo?-E-------oo--oo------oo----------oo?-----------------oo?-----oo?----
------XXB?M?------------o?M---------o?M-o?M-B?M?------------o--o----B--B--------o--o----o--o--------o?M-B?M?--------o--o--------o?M-B?M?----o--oo--o----o--o--------o?M-----------------o?M-----o?M-----
-----XXX-----------------o-B---------o-B-o-B------------------------B-EB-----------------------------o-B-------------------------o-B---------------------------------o-B-----------------o-B-----o-B----
----XXXX----------------------------------------------------X--X----BBBB--------X--X----X--X------------------------X--X--------------------X--XX--X----X--X-------------------------------------------v
-oo--oo?----BBBB-------------E-----------oo-----BBBB-----E-------oo------oo--------XBBBB-----oo------oo--oo------E---oo----------E-------E-----X-----oo?-----oo?-oo------oo?-----oo?BBBB---------------f
o--oo?M-----B--B------------B?M?--------o--o----B--B----B?M?----o--o----o--o--E---XXB--B----o--o----o--oo--o----B?M?o--o--------B?M?----B?M?--XX----o?M-----o?M-o--o----o?M-----o?M-B--B---------------f
-----o-B----B-EB--------------------------------B-EB-----------------------------XXXB-EB-----------------------------------------------------XXX-----o-B-----o-B---------o-B-----o-BB-EB---------------f
X--X--------BBBB------------------------X--X----BBBB------------X--X----X--XXXXXXXXXBBBB----X--X----X--XX--X--------X--X--------------------XXXX----------------X--X----------------BBBB---------------f
-E---T---E---------X-----E-------T---E---T-----X-----T-------E------BBBB-----oo-----BBBB-E---oo--T-------E---E---------X-------X-----E-------T---E---oo--E---------X-----MT--E----B----X-----T------BBBf
B?M?-|oTB?M?--E---XX--E-B?M?--E--|oTB?M?-|oT--XX--E--|oT--E-B?M?--E-B--B--E-o--o----B--BB?M?o--o-|oT--E-B?M?B?M?--E---XX--E---XX--E-B?M?--E--|oTB?M?o--oB?M?--E---XX--E---|-B?M?------XX--E--|oT--E-B--f
m----|-|---------XXX-------------|-|-----|-|-XXX-----|-|------------B-EB------------B-EB---------|-|-----------------XXX-----XXX-------------|-|-----------------XXX------|----------XXX-----|-|----B-EX
XX--XXXX----XXXXXXXXXXXX----XXXXXXXX----XXXXXXXXXXXXXXXXXXXX----XXXXBBBBXXXXX--X----BBBB----X--XXXXXXXXX--------XXXXXXXXXXXXXXXXXXXX----XXXXXXXX----X--X----XXXXXXXXXXXXXXXX----XXXXXXXXXXXXXXXXXXXXBBBX
