-oo?BBBB-----oo?-----oo--E---oo--E---E-------E---oo?---------E-------oo----------oo------oo------------------oo?-oo?-oo?-----oo----------oo?-oo?-oo?-----------------------------oo------oo-------------
o?M-B--B----o?M-----o--oB?M?o--oB?M?B?M?----B?M?o?M---------B?M?----o--o--------o--o----o--o----------------o?M-o?M-o?M-----o--o--------o?M-o?M-o?M-----------------------------o--o----o--o------------
-o-BB-EB-----o-B---------------------------------o-B---------------------------------------------------------o-B-o-B-o-B-----------------o-B-o-B-o-B----------------------------------------------------
----BBBB------------X--X----X--X------------------------------------X--X--------X--X----X--X--------------------------------X--X------------------------------------------------X--X----X--X------------
-oo--oo?-----oo----------oo--oo--oo?-E-------oo----------oo?-oo?BBBB-----oo?-oo-----BBBB----BBBB-E---oo--oo----------E-------oo?---XBBBB-oo------oo--oo--oo--oo?-E---oo-----BBBB-oo?---------E----------
o--oo?M-----o--o--------o--oo--oo?M-B?M?----o--o--------o?M-o?M-B--B----o?M-o--o----B--B----B--BB?M?o--oo--o--------B?M?----o?M---XXB--Bo--o----o--oo--oo--oo?M-B?M?o--o----B--Bo?M---------B?M?--------
-----o-B-------------------------o-B---------------------o-B-o-BB-EB-----o-B--------B-EB----B-EB-----------------------------o-B-XXXB-EB---------------------o-B------------B-EB-o-B--------------------
X--X--------X--X--------X--XX--X------------X--X----------------BBBB--------X--X----BBBB----BBBB----X--XX--X--------------------XXXXBBBBX--X----X--XX--XX--X--------X--X----BBBB-----------------------v
-oo?-----T-------T---oo?----BBBB-----E---oo?-oo?---------E-----------oo--oo----------oo--oo--------------oo?-----E-------oo?-oo----------oo?BBBB-----oo?---X-oo------oo?-----E--BBBB-----E------BBBB---f
o?M------|oT-----|oTo?M-----B--B----B?M?o?M-o?M---------B?M?--------o--oo--o--------o--oo--o------------o?M-----B?M?----o?M-o--o--------o?M-B--B----o?M---XXo--o----o?M-----B?M?B--B----B?M?----B--B---f
-o-B-----|-|-----|-|-o-B----B-EB---------o-B-o-B---------------------------------------------------------o-B-------------o-B-------------o-BB-EB-----o-B-XXX---------o-B--------B-EB------------B-EB---f
--------XXXX----XXXX--------BBBB------------------------------------X--XX--X--------X--XX--X--------------------------------X--X------------BBBB--------XXXXX--X----------------BBBB------------BBBB---f
----BBBB-T---E--BBBB-T---E------BBBB-----oo--MT------oo------E--BBBB---XBBBB-E--BBBB---X-----E---T---E---T--BBBB-----E---oo-----BBBB-E---oo-----BBBB-oo?-----E---MT--T---E-----X----BBBB-----E-------oof
--E-B--B-|oTB?M?B--B-|oTB?M?--E-B--B--E-o--o--|---E-o--o--E-B?M?B--B--XXB--BB?M?B--B--XX--E-B?M?-|oTB?M?-|oTB--B--E-B?M?o--o--E-B--BB?M?o--o--E-B--Bo?M---E-B?M?--|--|oTB?M?--XX--E-B--B--E-B?M?--E-o--f
m---B-EB-|-|----B-EB-|-|--------B-EB----------|-----------------B-EB-XXXB-EB----B-EB-XXX---------|-|-----|-|B-EB----------------B-EB------------B-EB-o-B----------|--|-|-----XXX----B-EB---------------X
XXXXBBBBXXXX----BBBBXXXX----XXXXBBBBXXXXX--XXXXXXXXXX--XXXXX----BBBBXXXXBBBB----BBBBXXXXXXXX----XXXX----XXXXBBBBXXXX----X--XXXXXBBBB----X--XXXXXBBBB----XXXX----XXXXXXXX----XXXXXXXXBBBBXXXX----XXXXX--X
