------------------------------------------------------------------------------------------------------------------------------X-?-----------------M------------------------------------------???--------
---------------------------------------------------------------------------------------------------------------------------------------------BBBBB--------------------------------------B---------------
----------------------------------------?-------------------------------------------------------------------------------------------------------------------------------BBBB----X-----------------------
--------------------------------------------X----------------------------------------------------B------------------------------------------------------------------M-----------------------------------
------------------------------------------------------------------------------------------------------????------------BBB-----------------------------------------------------------------------BBBBB---
-----------------------------------------------------------------------------------o-----------------------------------------------------------o--XXXXBXX---X-?-----------------------------------------
------------------------------------------------------------------------------------------------------------------------------------------------------B--X-----------------X----------------------------
--------------------------------------------------------------------------------------------------------------------------------------------------------XX----------------XX-o-------------------------v
-X----------------------------------------------------------------------??-----------------------------------------------------------------------X--XX-XXX---------------XXX----B-X--------------------f
-----------------------------------------------------------------------------------------------------------------X------------------------------------XXXX--------------XXXX-----XX------X-------------f
----------------------------------------------------------------------------------------------------------------XX----------------------------?-----XXXXXX-------------XXXXX----XXX-----XX-------X-----f
------------------------------------------------------------------------------------------------o--------------XXX-----?????----------------BBBBBBBXXXXXXX------------XXXXXX-XMXXXX----XXX----X--------f
-T----------------------------------------------------------------------T----------------------------------T--XXXX--T-----------------------------XXXXXTXX--------X--XXXXXXX??XXXXX---XXXXBT-X-X-------f
-|----------------------------------------------------------------------|----------------------------------|-XXXXX--|------------T--------M-----TXXXXXX|XX-------XX-XXXXXXXX-TXTXXX--XXXXX-|XXXXT----T-f
m|E---------------------------------------------------------------------|-----------------E-------------EE-|XXXXXX--|-E-------E--|-E--------E-E-|XXXXXX|XX------XXXXXXXXXXXXX|X|XXX-XXXXXX-|XXXX|---E|-X
X|-XXXXXXXXXXXXXXXXXXXXXXXXXXXXXXXXXXXXXXXXXXXXXXXXXXXXXXXXXXXXXXXXXXXXX|XXXXXXXXXXXXXXXXXXXXXXXXXXXXXXXXXX|XXXXXXXX|XXXXXXXXXXXX|XXXXXXXXXX?--X|XXXXXX|XXXXXXXXXXXXXXXXXXXXX|X|XXXXXXXXXXX|XXXX|XXXX|XX
