-------------oo------------------?o?-----E---?o?---X-?o?-----------------------------?o?-E-------?o?-E---?o?-----E---oo------oo----------------------?o?---------E---oo----------------------?o?-E---oo-
------------o--o----------------o-Mo----B?M?o-Mo--XXo-Mo----------------------------o-MoB?M?----o-MoB?M?o-Mo----B?M?o--o----o--o--------------------o-Mo--------B?M?o--o--------------------o-MoB?M?o--o
---------------------------------o-----------o---XXX-o-------------------------------o-----------o-------o-------------------------------------------o---------------------------------------o----------
------------X--X--------------------------------XXXX----------------------------------------------------------------X--X----X--X------------------------------------X--X----------------------------X--X
-?o?--------BBBB-?o?BBBBBBBB-?o?-------------?o?-oo------?o?-E---?o?-E-------E-------oo----------oo----------E-------?o?-?o?-?o?BBBBBBBB---XBBBB-E---E-------E-------oo--E-------oo--------X-oo--oo-----
o-Mo--------B--Bo-MoB--BB--Bo-Mo------E-----o-Moo--o----o-MoB?M?o-MoB?M?----B?M?----o--o--------o--o--------B?M?----o-Moo-Moo-MoB--BB--B--XXB--BB?M?B?M?----B?M?----o--oB?M?----o--o------XXo--oo--o----
-o----------B-EB-o--B-EBB-EB-o---------------o-----------o-------o---------------------------------------------------o---o---o--B-EBB-EB-XXXB-EB-----------------------------------------XXX------------
------------BBBB----BBBBBBBB--------XXXX--------X--X--------------------------------X--X--------X--X----------------------------BBBBBBBBXXXXBBBB--------------------X--X--------X--X----XXXXX--XX--X---v
-----E---T-------oo------E---oo--E-------E---------------------------?o?-E-----------oo--oo--E---------------?o?--------BBBB-?o?------------BBBB-?o?-E---?o?-----oo----------E---oo--oo------oo--oo----f
----B?M?-|oT----o--o----B?M?o--oB?M?----B?M?------------------------o-MoB?M?--------o--oo--oB?M?------------o-Mo--------B--Bo-Mo------------B--Bo-MoB?M?o-Mo----o--o------E-B?M?o--oo--o----o--oo--o---f
---------|-|---------------------------------------------------------o---------------------------------------o----------B-EB-o--------------B-EB-o-------o---------------------------------------------f
--------XXXX----X--X--------X--X----------------------------------------------------X--XX--X----------------------------BBBB----------------BBBB----------------X--X----XXXX----X--XX--X----X--XX--X---f
-E---------X-E------BBBB-------X----BBBB-----E---?o?-E-------E--------B------E---T---E-----X-----E---T--BBBB-----T--BBBB-----oo----X-----oo------oo------oo--E------BBBB-E------BBBB----BBBB-------X-E-f
B?M?--E---XXB?M?--E-B--B--E---XX--E-B--B--E-B?M?o-MoB?M?--E-B?M?--E-------E-B?M?-|oTB?M?--XX--E-B?M?-|oTB--B--E--|oTB--B--E-o--o--XX--E-o--o--E-o--o--E-o--oB?M?--E-B--BB?M?--E-B--B--E-B--B--E---XXB?Mf
m--------XXX--------B-EB-----XXX----B-EB---------o-------------------------------|-|-----XXX---------|-|B-EB-----|-|B-EB---------XXX--------------------------------B-EB--------B-EB----B-EB-----XXX---X
XX--XXXXXXXX----XXXXBBBBXXXXXXXXXXXXBBBBXXXX------------XXXX----XXXXXXXXXXXX----XXXX----XXXXXXXX----XXXXBBBBXXXXXXXXBBBBXXXXX--XXXXXXXXXX--XXXXXX--XXXXXX--X----XXXXBBBB----XXXXBBBBXXXXBBBBXXXXXXXX---X
