-------------------------------------B--------???--------------------------------------------------------------------------------------------------------------X-----------------X----------------------
-----------------------------o--------------------------------------------------------------------------------------------------------------------------------------------------------------------------
-----------------------------------------o----------------------------------------------------------------------XXXXXXX---------------------------------o----------------M---------------------B--------
--------------------------------------------------------------------XXXXXXX-----------------------------------------------------------------------------------------------------------------------------
-------------------B---------------?------------X----------------------------------------o--------------------------M-----------------------------------------------------------------------------------
-----------------------------------------------XX-------------------------------------------------------------------------------------B-----------------------------------------------------------------
----------------------------------------------XXX-------------------------------------------------------------------------------------XXXXXX-----------------o----------X---X-------------------------X-
---------------------------------------------XXXX----------------------------------------------------------------------M----------------------------------X------------XX--XX--------------M----------Xv
--------------------------------------------XXXXX------------?-------------------------------------------------------------------------------------------XX----o------XXX-XXX--------?----------------Xf
----------X------------------------X-----X-XXXXXX---------------------------------B------------------------?X------------------------X-XXXX-------------XXX----------XXXXXXXX-------------------------Xf
---------XX------------------o----XX----XXXXXXXXX----------------------------------------------------------XX-----------------------XX?----------------XXXX---------XXXXXXXXX-------------------------Xf
--------XXX----------------------XXX---XXXXXXXXXX--------------?------X-----------------------------------XXX----------------------XXX----------------XXXXX--------XXXXXXXXXX-------------------------Xf
-------XXXX---------------------XXXX--XXXXXXXXXXX----------------?---XX-----------------T---------------MXXXX---------------------XXXX-----------T---XXXXXX----o--XXXXXXXXXXT-------------------------Xf
---T--XXXXX-----T--------------XXXXX-XXXXXXXXXXXX----------------T--XXX-----------------|---------T-----XXXXX-T------------------XXXTX--------M--|--XXXXXXX------XXXXXXXXXXX|-------T------------B---XXf
m--|-XXXXXX-----|--------BE---XXXXXXXXXXXXXXXXXXX-E--------------|-XXXX-----------------|---------|----XXXXXX-|---------E------EXXXX|X-EE--------|-XXXXXXXX----EXXXXXXXXXXXX|-------|---E------X----XXXX
XXX|XXXXXXXXXXXX|XXXXXXXXXXXXXXXXXXXXXXXXXXXXXXXXXXXXXXXXXXXXXX-X|XXXXXXXXXXXXXXXXXXXXXX|XXXXXXXXX|XXXXXXXXXXX|MXXXXXX--XXXXXXXXXXXX|XXXXXXXXXXXX|XXXXXXXXXXXXXXXXXXXXXXXXXX|XXXXXXX|XXXXXXXX-XXXXXXXXXX
