-----------------------------------------------X--------------------------------------------------------------------------------------------------------------------------------------------------------
---B-------------------------------o-------------------------------------------------------??---------------------------------------------------X-------------------------------------------------------
------------------------?????------------------------------------------------------------------------o--------------------o-----------------------------------------------------------------------------
---B-----------XXXX----------------------------------------------------------BB-------------------------------------------------------------------------------------------------------------------------
---------------------------------------------M---------------------------------XXXXXXXX----------------X---X----------------------------------X---------------------------------------------------------
------------------------------------------------------------------------------------------------------XX--XX-----------X---------------------XX---------------------------------------------------------
----------------o--------------X-----------X---------------------------------------------------------XXX-XXX----------XX--------------------XXX---------------------------------------------------------
------------X----------???----XX---B----?-XX---------------------------------B----------------------XXXXXXXX---------XXX-------------------XXXX--------------------------------------------------------v
-----------------------------XXX---------XXX-------------------------------------------------------XXXXXXXXX--------XXXX-----------X------XXXXX--------------------------------------------------------f
----------------------------XXXX--------XXXX----?-------------------------???---------------------XXXXXXXXXX-------XXXXX----------XX-----XXXXXX--------------------------------------------------------f
---------------------------XXXXXB------XXXXX-----------------------------------------------X-----XXXXXXXXXXX------XXXXXX---------XXX----XXXXXXX--------------------------------------------------------f
--------------------------XXXXXX------XXXXXX----------------------------------------------XX----XXXXXXXXXXXX-----XXXXXXX-------XXXXX---XXXXXXXX--------------------------------------------------------f
-----------T-------------XXXXXXX-----XXXXXXX----------------------X----------------------XXX---XXXXXXXXXXXXX----XXXXXXXX-------XXXXX--XXXXXXXXX--------------------------------------------------------f
-------T---|------------XXXXXXXX----XXXXXXXX--------T--------????TX---------T-----XXXXX-XXXX--XXXXXXXXXXXTXX---XXXXXXXXX------XXXXXX-XXXXXXXXXX--------------------------------------------------------f
m------|---|---E-----E-XXXXXXXXX---XXXXXXXXX---E--E-|----E------X|X---------|o-------E-XXXXX-XXXXXXXXXXXX|XX--XXXXXXXXXX-----XXXXXXXXXXXXXXXXXX----E---------------------------------------------------X
XXXXXXX|X?X|XX--X--XX-XXXXXXXXXXXXXXXXXXXXXXX-XXXXXX|XXXXXXXXXXXX|XX?XXXXX-X|--XXXX--XXXXXXXXXXXXXXXXXXXX|XXXXXXXXXXXXXXXXXXXXXXXXXXXXXXXXXXXXXXXXXXXXXXXXXXXXXXXXXXXXXXXXXXXXXXXXXXXXXXXXXXXXXXXXXXXXXX
