--------------------------------------------------------------------------------------------------------------------------------------------------------------------------------------------------------
---------------------------------------------------------------------------------------------------------------------------------------------M----------------------------------------------------------
----------------------------------------o---------------------------------------------------------------------------------------------------------------------------------------------------------------
--------------------------------M-----------------------------------------------------------------------------------------------------------------------------------------------------------------B-----
-----------------------------------------------------------------------------------------------------------------------------X----------------????---------------X--------Bo---B------------------------
----------------------------------------------------------------------------------------------------------------------------XX----------------------------------XX----------------------M-------o-------
---------------------------------------------------------------------------------------------------------------------------XXX----------????-------------X-----XXX------X-------------------------------
----------------------------------------X---------------------------------------------------------------------------------XXXX--------------------------XX----XXXX-----X----------------B--------------v
---------------------------------------XX---------------------------------------------------------------X----------------XXXXX-------------------------XXX---XXXXX----XX-------------------------------f
--------------------------------------XXX--------------------------------------------------------------XX----------X----XXXXXX------------------------XXXX--XXXXXX---XXX--------BBBBBBB---B------------f
-------------------------------------XXXX-----------BBB-----------------------------------------------XXX-----XXXXXXX--XXXXXXX-------------X---------XXXXX-XXXXXXX--XXXXXXX----------------------X-----f
------------------------------------XXXXX--X---------------------------------------------------------XXXX--------XXX--XXXXXXXX------o-----XX--------XXXXXXXXXXXXXX-XXXXX---------------X---------------f
-----------------------------------XXXXXX-XX---------------------------T----------------------------XXXXX-------XXXX-XXXXXXXXX------X--T-XXX-------XXXXXXXXXXXXXXXXXXXXX--------------XXT--------------f
----------------------------------XXXXXXXXXX---------------------------|---------------------------XXXXXX------XXXXXTXXXXXXXXX---------|XXTX------XXXXXXXXXXXXXXXXXXXXXX-------------XXX|--------T-----f
m--------------------------------XXXXXXXXXXX---------------------------|--------------------------XXXXXXX-----XXXXXX|XXXXXXXXX---------|XX|X-----XXXXXXXXXXXXXXXXXXXXXXX------------XXXX|--------|-----X
XXXXXXXXXXXXXXXXXXXXXXXXXXXX?XXXXXXXXXXXXXXXXXXXXXXXXXXXXXXXXXXXXXXXXXX|XXXXXXXXXXXXXXXXXXXXXXXXXXXXXXXXXXXXXXXXXXXX|XXXXXXXXXXXXXXXXXX|XX|XXX-XXXXXXXXXXXXXXXXXXXXXXXXXXXXXXXXXXX-XXXXX|XXXXXXX-|XXXXXX
