------?---------------------------------------o---------------------------------------------------------------------------------------------------------------------------------------------------------
-------------------------------------------------------------------------------------------------------------------------------------------------------------------------------o------------------------
-------------------------?------------------------------------------------------------------------------------------------------------------------------------------------------------------------------
--------------------------------------------------------------------------------------------------------------------------------------------------------------------------------------------------------
------------B---------------------------------------------------------------------------------------------------o---------------------------------------------------------------------------------------
--------------------------------------------------------------------------------------------------------------------------------------------------------------------------------------------------------
--------------------------------------X-----------------------------------------------------------------------------------------------------------------------------------------------------------------
----------------X--------------------XX----------------------------------------------------------------------------------------------------------------------------------------------------------------v
---------o--------------------------XXX----------------------------------------------------------------------------------------------------------------------------------------------------------------f
-----------------------------------XXXX----------------------------------------------------------------------------------------------------------------------------------------------------------------f
--------------------??------------XXXXX----------------------------------------------------------------------------------------------------------------------------------------------------------------f
---------------------------------XXXXXX----------------------------------------------------------------------------------------------------------------------------------------------------------------f
--------------------------------XXXXTXX----------M-----------------------------------------------------------------------------------------------------------------------------------------------------f
----T--------------------------XXXXX|XX-----T----------------------------------------------------------------------------------------------------------------------------------------------------------f
m---|---E---------------------XXXXXX|XX-----|-------------------------------------------------------------------------------------------------------------------E--------------------------------------X
XXXX|XXX?MX-XXXXXXXXXXXXXXXXXXXXXXXX|XXXXXXX|XXXXXXXXXXXXXXXXXXXXXXXXXXXXXXXXXXXXXXXXXXXXXXXXXXXXXXXXXXXXXXXXXXXXXXXXXXXXXXXXXXXXXXXXXXXXXXXXXXXXXXXXXXXXXXXXXXXXXXXXXXXXXXXXXXXXXXXXXXXXXXXXXXXXXXXXXXX
