-oo--E----------Boo?-----oo------------------oo------E--Boo?-oo------E-------oo-----Boo?-oo--------------E--------------Boo?---------oo--E---oo-Boo?---X-E--Boo?-----oo--------------oo----X-E-------E--
o--oB?M?--------o-Mo----o--o----------------o--o----B?M?o-Moo--o----B?M?----o--o----o-Moo--o------------B?M?------------o-Mo--------o--oB?M?o--oo-Mo--XXB?M?o-Mo----o--o------------o--o--XXB?M?----B?M?
-----------------X---------------------------------------X---------------------------X-----------------------------------X-----------------------X---XXX-----X---------------------------XXX------------
X--X--------------------X--X----------------X--X------------X--X------------X--X--------X--X----------------------------------------X--X----X--X----XXXX------------X--X------------X--XXXXX------------
-----E---oo--E---oo------E-------oo------oo------oo--------------oo------oo------E------Boo?---------oo------oo----------oo-Boo?-oo----XBoo?-----oo---------Boo?-------------oo--E------Boo?Boo?-oo-----
----B?M?o--oB?M?o--o----B?M?----o--o----o--o----o--o--E---------o--o----o--o----B?M?----o-Mo--------o--o----o--o--------o--oo-Moo--o--XXo-Mo----o--o--------o-Mo------------o--oB?M?----o-Moo-Moo--o----
-----------------------------------------------------------------------------------------X-----------------------------------X-------XXX-X-------------------X---------------------------X---X----------
--------X--X----X--X------------X--X----X--X----X--XXXXX--------X--X----X--X------------------------X--X----X--X--------X--X----X--XXXXX--------X--X------------------------X--X----------------X--X---v
-oo-------------Boo?-E--Boo?-E-------------X-E--Boo?--------Boo?-----oo------E-------------------E--Boo?-oo-Boo?---X-oo----------oo------oo--oo------oo------oo-Boo?-oo--oo-Boo?----Boo?-----E---------f
o--o------------o-MoB?M?o-MoB?M?----------XXB?M?o-Mo--------o-Mo----o--o----B?M?----------------B?M?o-Moo--oo-Mo--XXo--o--------o--o----o--oo--o----o--o----o--oo-Moo--oo--oo-Mo----o-Mo----B?M?-------f
-----------------X-------X---------------XXX-----X-----------X---------------------------------------X-------X---XXX---------------------------------------------X-----------X-------X-----------------f
X--X------------------------------------XXXX------------------------X--X--------------------------------X--X----XXXXX--X--------X--X----X--XX--X----X--X----X--X----X--XX--X---------------------------f
---X-E---T---E---T-------E-------E-----X-T-------T---E-------T---E-------oo------E-----X-----T-------T---E-------oo------E---------X-E---------X-oo------T-------T-----X-----T---E---T---E-------E-----f
--XXB?M?-|oTB?M?-|oT--E-B?M?--E-B?M?--XX-|oT--E--|oTB?M?--E--|oTB?M?--E-o--o--E-B?M?--XX--E--|oT--E--|oTB?M?--E-o--o--E-B?M?--E---XXB?M?--E---XXo--o--E--|oT--E--|oT--XX--E--|oTB?M?-|oTB?M?--E-B?M?--Xf
mXXX-----|-|-----|-|-----------------XXX-|-|-----|-|---------|-|---------------------XXX-----|-|-----|-|-------------------------XXX---------XXX---------|-|-----|-|-XXX-----|-|-----|-|-------------XXX
XXXX----XXXX----XXXXXXXX----XXXX----XXXXXXXXXXXXXXXX----XXXXXXXX----XXXXX--XXXXX----XXXXXXXXXXXXXXXXXXXX----XXXXX--XXXXX----XXXXXXXX----XXXXXXXXX--XXXXXXXXXXXXXXXXXXXXXXXXXXXXX----XXXX----XXXX----XXXX
