---------------------?o?-oo--------------E---------------oo--------------oo--?o?BBBB---------oo--?o?-oo------E---oo------E----------BBBB-?o?-E-------oo------oo--oo--oo--?o?---------E---?o?---------E--
--------------------o-Moo--o------------B?M?------------o--o------E-----o--oo-MoB--B--------o--oo-Moo--o----B?M?o--o----B?M?--------B--Bo-MoB?M?----o--o----o--oo--oo--oo-Mo--------B?M?o-Mo--------B?M?
---------------------o-------------------------------------------------------o--B-EB-------------o----------------------------------B-EB-o-------------------------------o---------------o--------------
------------------------X--X----------------------------X--X----XXXX----X--X----BBBB--------X--X----X--X--------X--X----------------BBBB------------X--X----X--XX--XX--X--------------------------------
----------------BBBB-oo--------X-----E-------oo------oo------?o?-----oo------oo------?o?-E-----------?o?--------BBBB-----oo-BBBB---------E---oo-----BBBB-?o?BBBB---X-oo-----BBBB-?o?-----?o?-oo------E--
----------------B--Bo--o------XX----B?M?----o--o----o--o----o-Mo----o--o----o--o----o-MoB?M?--------o-Mo--------B--B----o--oB--B--------B?M?o--o----B--Bo-MoB--B--XXo--o----B--Bo-Mo----o-Moo--o----B?M?
----------------B-EB---------XXX-----------------------------o-----------------------o---------------o----------B-EB--------B-EB--------------------B-EB-o--B-EB-XXX--------B-EB-o-------o--------------
----------------BBBBX--X----XXXX------------X--X----X--X------------X--X----X--X--------------------------------BBBB----X--XBBBB------------X--X----BBBB----BBBBXXXXX--X----BBBB------------X--X-------v
----BBBB-oo------E-------E---?o?-E-------E-------oo--?o?-oo--?o?-E-------oo--E-----------?o?---------E---oo--E-------E---E-----------E---?o?----BBBB-----?o?-------------?o?BBBB-----E---------XBBBB-?of
----B--Bo--o----B?M?----B?M?o-MoB?M?----B?M?----o--oo-Moo--oo-MoB?M?----o--oB?M?--------o-Mo--------B?M?o--oB?M?----B?M?B?M?--------B?M?o-Mo----B--B----o-Mo------------o-MoB--B----B?M?------XXB--Bo-Mf
----B-EB---------------------o-----------------------o-------o---------------------------o-----------------------------------------------o------B-EB-----o---------------o--B-EB-------------XXXB-EB-o-f
----BBBBX--X------------------------------------X--X----X--X------------X--X----------------------------X--X------------------------------------BBBB------------------------BBBB------------XXXXBBBB---f
-T---------X-E---E---T--------B----X-E-------E--BBBB-T-------oo--------X-----T---E--BBBB-----E--BBBB-------X-----E-----X-----E--BBBB-----oo--E-------E---oo--E---oo--E---oo------E-------E---T---E---T-f
-|oT--E---XXB?M?B?M?-|oT--E-------XXB?M?--E-B?M?B--B-|oT--E-o--o--E---XX--E--|oTB?M?B--B--E-B?M?B--B--E---XX--E-B?M?--XX--E-B?M?B--B--E-o--oB?M?--E-B?M?o--oB?M?o--oB?M?o--o--E-B?M?--E-B?M?-|oTB?M?-|of
m|-|-----XXX---------|-|---------XXX------------B-EB-|-|-------------XXX-----|-|----B-EB--------B-EB-----XXX---------XXX--------B-EB---------------------------------------------------------|-|-----|-X
XXXXXXXXXXXX--------XXXXXXXXXXXXXXXX----XXXX----BBBBXXXXXXXXX--XXXXXXXXXXXXXXXXX----BBBBXXXX----BBBBXXXXXXXXXXXX----XXXXXXXX----BBBBXXXXX--X----XXXX----X--X----X--X----X--XXXXX----XXXX----XXXX----XXXX
