-T---oo------oo------------------------X-oo--------------oo----------------------------------------------------------------------------------------------------------------------------------oo------oo-
-|oTo--o----o--o----------------------XXo--o------------o--o--------------------------------------------------------------------------------------------------------------------------------o--o----o--o
-|-|---------------------------------XXX----------------------------------------------------------------------------------------------------------------------------------------------------------------
XXXXX--X----X--X--------------------XXXXX--X------------X--X--------------------------------------------------------------------------------------------------------------------------------X--X----X--X
---X-----oo--------X-oo--oo------------------oo------oo------------------oo----------oo------oo----------oo------oo------T---------------------------oo----------oo------oo------oo------oo-------------
--XX----o--o------XXo--oo--o----------------o--o----o--o----------------o--o--------o--o----o--o--------o--o----o--o-----|oT------------------------o--o--------o--o----o--o----o--o----o--o------------
-XXX-------------XXX-----------------------------------------------------------------------------------------------------|-|----------------------------------------------------------------------------
XXXX----X--X----XXXXX--XX--X----------------X--X----X--X----------------X--X--------X--X----X--X--------X--X----X--X----XXXX------------------------X--X--------X--X----X--X----X--X----X--X-----------v
-----oo------oo----X-------X---------oo----------oo------oo----------oo------oo----------oo------------------oo------oo------oo------------------oo------oo------------------oo----------oo--oo------oof
----o--o----o--o--XX------XX--------o--o--------o--o----o--o--------o--o----o--o--------o--o----------------o--o----o--o----o--o----------------o--o----o--o----------------o--o--------o--oo--o----o--f
-----------------XXX-----XXX---------------------------------------------------------------------------------------------------------------------------------------------------------------------------f
----X--X----X--XXXXX----XXXX--------X--X--------X--X----X--X--------X--X----X--X--------X--X----------------X--X----X--X----X--X----------------X--X----X--X----------------X--X--------X--XX--X----X--f
-T-------oo------T---oo----------oo------E---T-------oo------T---------X-oo----------T-------oo----------T-------oo--------X-----oo--------X-oo------oo--------X-oo--E---oo------T---E-----X-----T-----f
-|oT--E-o--o--E--|oTo--o--E---E-o--o--E-B?M?-|oT--E-o--o--E--|oT--E---XXo--o--E---E--|oT--E-o--o--E---E--|oT--E-o--o--E---XX--E-o--o--E---XXo--o--E-o--o--E---XXo--oB?M?o--o--E--|oTB?M?--XX--E--|oT--Ef
m|-|-------------|-|-------------------------|-|-------------|-|-----XXX-------------|-|-----------------|-|-------------XXX-------------XXX-----------------XXX-----------------|-|-----XXX-----|-|---X
XXXXXXXXX--XXXXXXXXXX--XXXXXXXXXX--XXXXX----XXXXXXXXX--XXXXXXXXXXXXXXXXXX--XXXXXXXXXXXXXXXXXX--XXXXXXXXXXXXXXXXXX--XXXXXXXXXXXXXX--XXXXXXXXXX--XXXXXX--XXXXXXXXXX--X----X--XXXXXXXXX----XXXXXXXXXXXXXXXX
