-----------------oo------------------------------------------------------------------------------------------------------------------------------------------------------------------------------------X
----------------o--o----------------------------------------------------------------------------------------------------------------------------------------------------------------------------------XX
-----------------------------------------------------------------------------------------------------------------------------------------------------------------------------------------------------XXX
----------------X--X--------------------------------------------------------------------------------------------------------------------------------------------------------------------------------XXXX
-oo------oo--------X-oo------oo------oo--E-------oo----------oo------oo----------------------oo------oo------------------oo----------oo--oo----------oo------oo------oo------------------oo------oo-----
o--o----o--o------XXo--o----o--o----o--oB?M?----o--o--------o--o----o--o--------------------o--o----o--o----------------o--o--------o--oo--o--------o--o----o--o----o--o----------------o--o----o--o----
-----------------XXX------------------------------------------------------------------------------------------------------------------------------------------------------------------------------------
X--X----X--X----XXXXX--X----X--X----X--X--------X--X--------X--X----X--X--------------------X--X----X--X----------------X--X--------X--XX--X--------X--X----X--X----X--X----------------X--X----X--X---v
-----oo------oo----------oo------oo------oo----------oo----------oo------oo--------------oo------oo------oo------oo--oo------oo------------------oo------oo------oo------oo----------oo----X-oo--------f
----o--o----o--o--------o--o----o--o----o--o--------o--o--------o--o----o--o------------o--o----o--o----o--o----o--oo--o----o--o----------------o--o----o--o--E-o--o----o--o--------o--o--XXo--o-------f
-----------------------------------------------------------------------------------------------------------------------------------------------------------------------------------------XXX-----------f
----X--X----X--X--------X--X----X--X----X--X--------X--X--------X--X----X--X------------X--X----X--X----X--X----X--XX--X----X--X----------------X--X----X--XXXXXX--X----X--X--------X--XXXXXX--X-------f
-oo------oo--oo------oo------oo------oo----X-E---oo--------X-oo------oo------oo------oo------oo------oo------oo----X-----oo------T-------T---E-------oo------oo------oo----------T---------X-----T-----f
o--o--E-o--oo--o--E-o--o--E-o--o--E-o--o--XXB?M?o--o--E---XXo--o--E-o--o--E-o--o--E-o--o--E-o--o--E-o--o--E-o--o--XX--E-o--o--E--|oT--E--|oTB?M?--E-o--o--E-o--o--E-o--o--E---E--|oT--E---XX--E--|oT--Ef
m----------------------------------------XXX-------------XXX-----------------------------------------------------XXX-------------|-|-----|-|-------------------------------------|-|-----XXX-----|-|---X
XX-XXXXXX--XX--XXXXXX--XXXXXX--XXXXXX--XXXXX----X--XXXXXXXXXX--XXXXXX--XXXXXX--XXXXXX--XXXXXX--XXXXXX--XXXXXX--XXXXXXXXXX--XXXXXXXXXXXXXXXXX----XXXXX--XXXXXX--XXXXXX--XXXXXXXXXXXXXXXXXXXXXXXXXXXXXXXXX
