-----------------------------------------------------------------------------------------------------------------------------------------oo----------E-------oo?-E--BBBB-E------------------------------
----------------------------------------------------------------------------------------------------------------------------------------o--o--------B?M?----o?M-B?M?B--BB?M?----------------------------
-------------------------------------------------------------------------------------------------------------------------------------------------------------o-B----B-EB--------------------------------
----------------------------------------------------------------------------------------------------------------------------------------X--X------------------------BBBB--------------------------------
-oo?-------------oo--oo?-oo?-oo?BBBB-----oo--oo?---X-E---oo--oo---------BBBB------B-----BBBB-----oo?-oo--oo?----------------BBBB-------------oo------------X-oo------oo------oo?-oo----------oo---------
o?M-------------o--oo?M-o?M-o?M-B--B----o--oo?M---XXB?M?o--oo--o--------B--B------------B--B----o?M-o--oo?M-----------------B--B------------o--o----------XXo--o----o--o----o?M-o--o--------o--o--------
-o-B-----------------o-B-o-B-o-BB-EB---------o-B-XXX--------------------B-EB------------B-EB-----o-B-----o-B----------------B-EB-------------------------XXX-----------------o-B------------------------
----------------X--X------------BBBB----X--X----XXXX----X--XX--X--------BBBB----XXXX----BBBB--------X--X--------------------BBBB------------X--X--------XXXXX--X----X--X--------X--X--------X--X-------v
---------oo--E---------------oo------E-----X-oo--oo?-------------oo--------------oo?-----oo------oo--E-------E-------oo?-oo?---------------------oo?----BBBB-----oo?---X-E---oo?-oo?---------oo?-----E-f
--------o--oB?M?------------o--o----B?M?--XXo--oo?M-------------o--o------------o?M-----o--o----o--oB?M?----B?M?----o?M-o?M---------------------o?M-----B--B--E-o?M---XXB?M?o?M-o?M---------o?M-----B?Mf
-----------------------------------------XXX-----o-B-----------------------------o-B---------------------------------o-B-o-B---------------------o-B----B-EB-----o-B-XXX-----o-B-o-B---------o-B-------f
--------X--X----------------X--X--------XXXXX--X----------------X--X--------------------X--X----X--X----------------------------------------------------BBBBXXXX----XXXX-------------------------------f
BBBB-E-----X-----E-------oo------oo?---X---X---X-----E-----X-E-----XBBBB-MT-BBBB---------oo?-E-----X-------X-----E---oo------E--BBBB---XBBBB-MT------E-------E---T---E-------oo------MT--T------BBBB---f
B--BB?M?--XX--E-B?M?--E-o--o--E-o?M---XX--XX--XX--E-B?M?--XXB?M?--XXB--B--|-B--B--E---E-o?M-B?M?--XX--E---XX--E-B?M?o--o--E-B?M?B--B--XXB--B--|---E-B?M?--E-B?M?-|oTB?M?--E-o--o--E---|--|oT--E-B--B--Ef
m-EB-----XXX---------------------o-B-XXX-XXX-XXX---------XXX-----XXXB-EB--|-B-EB---------o-B-----XXX-----XXX--------------------B-EB-XXXB-EB--|------------------|-|------------------|--|-|----B-EB---X
XXBB----XXXXXXXX----XXXXX--XXXXX----XXXXXXXXXXXXXXXX----XXXX----XXXXBBBBXXXXBBBBXXXXXXXX--------XXXXXXXXXXXXXXXX----X--XXXXX----BBBBXXXXBBBBXXXXXXXX----XXXX----XXXX----XXXXX--XXXXXXXXXXXXXXXXXBBBBXXXX
