---------------------------------------------------------------------------------------------------------------------------------------------oo--oo--E-----X-oo?-E--------------------------------------
--------------------------------------------------------------------------------------------------------------------------------------------o--oo--oB?M?--XXo?M-B?M?------------------------------------
---------------------------------------------------------------------------------------------------------------------------------------------------------XXX-o-B----------------------------------------
--------------------------------------------------------------------------------------------------------------------------------------------X--XX--X----XXXX--------------------------------------------
-----oo?---------oo-BBBB---------------X-----oo?------------BBBB-oo?-E---E-----------E----B--oo?-oo?BBBB--------------B----X-----E---oo--E-------oo--E-------oo?-------X----BBBB-oo------oo?-----oo-BBBB
----o?M---------o--oB--B--------------XX----o?M-------------B--Bo?M-B?M?B?M?--------B?M?----o?M-o?M-B--B------------------XX----B?M?o--oB?M?----o--oB?M?----o?M-------XX----B--Bo--o----o?M-----o--oB--B
-----o-B------------B-EB-------------XXX-----o-B------------B-EB-o-B-------------------------o-B-o-BB-EB-----------------XXX---------------------------------o-B-----XXX----B-EB---------o-B--------B-EB
----------------X--XBBBB------------XXXX--------------------BBBB------------------------XXXX--------BBBB------------XXXXXXXX--------X--X--------X--X----------------XXXX----BBBBX--X------------X--XBBBv
-------------E---oo?-oo?-T-------oo------oo--oo?-oo--oo------oo?-----E------BBBB---X-oo--------------E------BBBB-oo--oo?-----oo?-----oo?-----oo?---X-oo?---X-oo----------oo-----BBBB-----oo?-----oo?-oof
------------B?M?o?M-o?M--|oT----o--o----o--oo?M-o--oo--o----o?M-----B?M?--E-B--B--XXo--o------------B?M?----B--Bo--oo?M-----o?M-----o?M-----o?M---XXo?M---XXo--o--------o--o----B--B----o?M-----o?M-o?Mf
-----------------o-B-o-B-|-|-----------------o-B-------------o-B------------B-EB-XXX------------------------B-EB-----o-B-----o-B-----o-B-----o-B-XXX-o-B-XXX--------------------B-EB-----o-B-----o-B-o-f
------------------------XXXX----X--X----X--X----X--XX--X----------------XXXXBBBBXXXXX--X--------------------BBBBX--X----------------------------XXXX----XXXXX--X--------X--X----BBBB-------------------f
-T-------oo--oo------T-------E-------T-------T---T-----X-E---T--BBBB-----E----B---B------E---oo--E-------oo--------X-oo------T---E---T---E---T---E---oo--T-------E---oo------oo------MT--E--BBBB-----oof
-|oT--E-o--oo--o--E--|oT--E-B?M?--E--|oT--E--|oT-|oT--XXB?M?-|oTB--B--E-B?M?----------E-B?M?o--oB?M?--E-o--o--E---XXo--o--E--|oTB?M?-|oTB?M?-|oTB?M?o--o-|oT--E-B?M?o--o--E-o--o--E---|-B?M?B--B--E-o--f
m|-|-----------------|-|-------------|-|-----|-|-|-|-XXX-----|-|B-EB---------------------------------------------XXX---------|-|-----|-|-----|-|---------|-|--------------------------|-----B-EB-------X
XXXXXXXXX--XX--XXXXXXXXXXXXX----XXXXXXXXXXXXXXXXXXXXXXXX----XXXXBBBBXXXX----XXXXXXXXXXXX----X--X----XXXXX--XXXXXXXXXX--XXXXXXXXX----XXXX----XXXX----X--XXXXXXXXX----X--XXXXXX--XXXXXXXXX----BBBBXXXXX--X
