-------------oo--oo--------------oo------oo--------------------------oo------oo--oo----X-----oo----------------------------------------------oo------oo--------------oo----------oo----------oo---------
------------o--oo--o------------o--o----o--o------------------------o--o----o--oo--o--XX----o--o--------------------------------------------o--o----o--o------------o--o--------o--o--------o--o--------
-------------------------------------------------------------------------------------XXX----------------------------------------------------------------------------------------------------------------
------------X--XX--X------------X--X----X--X------------------------X--X----X--XX--XXXXX----X--X--------------------------------------------X--X----X--X------------X--X--------X--X--------X--X--------
-oo------oo----------oo------oo------oo------oo------oo------------------oo--------------oo------oo--------------------X---------oo--------------oo------oo------oo----X-oo--------------oo--oo---------
o--o----o--o--------o--o----o--o----o--o----o--o----o--o----------------o--o------------o--o----o--o------------------XX--------o--o------------o--o----o--o----o--o--XXo--o------------o--oo--o--------
---------------------------------------------------------------------------------------------------------------------XXX---------------------------------------------XXX--------------------------------
X--X----X--X--------X--X----X--X----X--X----X--X----X--X----------------X--X------------X--X----X--X----------------XXXX--------X--X------------X--X----X--X----X--XXXXXX--X------------X--XX--X-------v
-----oo------oo--oo------oo------oo------oo------oo------oo------oo----------oo------oo------oo--------------E---oo------oo--T-------oo------oo------oo------oo----------oo----X-----------------oo----f
----o--o--E-o--oo--o----o--o----o--o----o--o----o--o----o--o----o--o--------o--o----o--o----o--o------------B?M?o--o----o--o-|oT----o--o----o--o----o--o----o--o--------o--o--XX----------------o--o---f
-----------------------------------------------------------------------------------------------------------------------------|-|---------------------------------------------XXX-----------------------f
----X--XXXXXX--XX--X----X--X----X--X----X--X----X--X----X--X----X--X--------X--X----X--X----X--X----------------X--X----X--XXXXX----X--X----X--X----X--X----X--X--------X--XXXXX----------------X--X---f
-oo------oo--------X-oo------oo------oo------oo------oo------oo--------X-oo------oo------oo------oo------T-----------oo--------X-oo------oo------oo------oo----X-----T---------X-----oo--E---oo------oof
o--o--E-o--o--E---XXo--o--E-o--o--E-o--o--E-o--o--E-o--o--E-o--o--E---XXo--o--E-o--o--E-o--o--E-o--o--E--|oT--E---E-o--o--E---XXo--o--E-o--o--E-o--o--E-o--o--XX--E--|oT--E---XX--E-o--oB?M?o--o--E-o--f
m----------------XXX-------------------------------------------------XXX---------------------------------|-|-----------------XXX-----------------------------XXX-----|-|-----XXX-----------------------X
XX-XXXXXX--XXXXXXXXXX--XXXXXX--XXXXXX--XXXXXX--XXXXXX--XXXXXX--XXXXXXXXXX--XXXXXX--XXXXXX--XXXXXX--XXXXXXXXXXXXXXXXXX--XXXXXXXXXX--XXXXXX--XXXXXX--XXXXXX--XXXXXXXXXXXXXXXXXXXXXXXXXX--X----X--XXXXXX--X
