------------------------------------------------------------------------------------------------------------------------X--------------------------------------------------------M-----------------o----
-----------------o-------------------------------------------------------------------------------BBXXXX--------------------------------------XXXXXXXX---M--------------------?--------------------------
----------------------------------?--------------------------------------------------------------------------------------M------------------------------------------------------------------------------
--------------------------------------o------------o-----------------------------------------------???--------------------------------------------------------------------------------------------------
----------------------------------o-----------------------------------------------X-------------------------------------------------------------BBBBBBBB---------B----M---------------------------------
---------------o-----------------------------------------------------------------XX---------------------------------------------------------------------------------------M-----------X-----------------
-B------------------------------------------------------------------------------XXX------------------------------BBBBBBBB----------------------------------------------------------X-XX-------BBBB------
----------------o--------------------------------------------------------------XXXX-----------------------------------------------------------------------------------------------XXXXX------X--X------v
----------------------------------------------------?-------------------------XXXXX-------------------o--------X------------o----------------------------------------------------XXXXXX-----XX-XX-----Xf
-----------------------------------------------------------------------------XXXXXX--------------B------------XX--------------------X-------------------------------------------XXXXXXX----XXXXXX-----Xf
---------------------------------X----------------------X-X-----------------XXXXXXX--------------------------XXX---------------------------------------------------------------XXXXXXXX---XXXXXXXBB---Xf
-----------------X--------------XX-----------------------XX---------------oXXXXXXXX-------------o-----------XXXX-----------------o--------------------------------------------XXXXXXXXX--XXXXXXXX-BBBBXf
---------------------------?---XXX---T------------------XXX---------------XXXXXXXXX----------------T--T----XXXXX---------TB--------------T---------T----T---------T----------XXXXXXXXXX-XXXXXXXXX-----Xf
------------------------------XXXX---|-----------------XXXX--------------XXXXXXXXXX----------T-----|--|---XTXXTX---------|--T------------|---------|--XX|T--------|X--------XXXXXXXXXXXXXXXXXXXXT-----Xf
m----------------------------XXXXX---|----------E-----XXXXX-------------XXXXXXXXXXX---E------|-----|--|--XX|XX|X------E--|--|--XE--------|-B-------|----||-----o--|---E----XXXXXXXXXXXXXXXXXXXXX|----EXX
XXX--XXXXXXXXXXXXXXXXX????XXXXXXXXX--|XXX-XXXXXXXXXXXXXXXXXXXXXXXXXXXXXXXXXXXXXXXXXXXXXXXXXXX|XBXX-|XX|XXXX|XX|XXXXXXXXXX|-X|XXXXXXXXXXXX|---XX--XX|XXXX||XXXX-XXX|XXXXXXXXXXXXXXXXXXXXXXXXXXXXX|XXXXXXX
