-----------------------------oo----------------------------------------------------------------------------------oo----------------------------------oo------oo-----------------------------------------
----------------------------o--o--------------------------------------------------------------------------------o--o--------------------------------o--o----o--o----------------------------------------
--------------------------------------------------------------------------------------------------------------------------------------------------------------------------------------------------------
----------------------------X--X--------------------------------------------------------------------------------X--X--------------------------------X--X----X--X----------------------------------------
---X-----oo------oo----X-oo------oo------oo------oo----------oo--------------------------oo--------X-oo--------------oo----------------X-oo------oo------oo------oo------oo----------oo------E---oo----X
--XX----o--o----o--o--XXo--o----o--o----o--o----o--o--------o--o------------------------o--o------XXo--o------------o--o--------------XXo--o----o--o----o--o----o--o----o--o--------o--o----B?M?o--o--XX
-XXX-----------------XXX-------------------------------------------------------------------------XXX---------------------------------XXX-------------------------------------------------------------XXX
XXXX----X--X----X--XXXXXX--X----X--X----X--X----X--X--------X--X------------------------X--X----XXXXX--X------------X--X------------XXXXX--X----X--X----X--X----X--X----X--X--------X--X--------X--XXXXv
-----oo------oo--------------oo------oo------oo------oo--E-----------oo------oo------oo------oo----------oo------oo------oo------oo----------oo------oo------oo------oo--------------------------------f
----o--o--E-o--o------------o--o----o--o----o--o----o--oB?M?--------o--o----o--o----o--o----o--o--------o--o----o--o----o--o----o--o--------o--o----o--o----o--o----o--o-------------------------------f
-------------------------------------------------------------------------------------------------------------------------------------------------------------------------------------------------------f
----X--XXXXXX--X------------X--X----X--X----X--X----X--X------------X--X----X--X----X--X----X--X--------X--X----X--X----X--X----X--X--------X--X----X--X----X--X----X--X-------------------------------f
-oo------oo------oo--E---oo------oo------oo------oo------T---oo----X-------X-----oo------oo--T-------oo------oo------oo------oo------oo----------oo------oo------oo------oo--T---E---oo--T-----X-oo--T-f
o--o--E-o--o--E-o--oB?M?o--o--E-o--o--E-o--o--E-o--o--E--|oTo--o--XX--E---XX--E-o--o--E-o--o-|oT--E-o--o--E-o--o--E-o--o--E-o--o--E-o--o--E---E-o--o--E-o--o--E-o--o--E-o--o-|oTB?M?o--o-|oT--XXo--o-|of
m--------------------------------------------------------|-|-----XXX-----XXX-----------------|-|-----------------------------------------------------------------------------|-|---------|-|-XXX-----|-X
XX-XXXXXX--XXXXXX--X----X--XXXXXX--XXXXXX--XXXXXX--XXXXXXXXXX--XXXXXXXXXXXXXXXXXX--XXXXXX--XXXXXXXXXX--XXXXXX--XXXXXX--XXXXXX--XXXXXX--XXXXXXXXXX--XXXXXX--XXXXXX--XXXXXX--XXXXX----X--XXXXXXXXXX--XXXXX
