-oo--E-----------E-------E---------------E---oo?-----E-------E-----------------------E-------------------oo--E--BBBB-----E--BBBB-----E--BBBB-----oo----------oo?-E---oo?-oo------------------oo?-E------
o--oB?M?--------B?M?----B?M?------------B?M?o?M-----B?M?----B?M?--------------------B?M?----------------o--oB?M?B--B----B?M?B--B----B?M?B--B----o--o--------o?M-B?M?o?M-o--o----------E-----o?M-B?M?----
---------------------------------------------o-B----------------------------------------------------------------B-EB--------B-EB--------B-EB-----------------o-B-----o-B---------------------o-B--------
X--X----------------------------------------------------------------------------------------------------X--X----BBBB--------BBBB--------BBBB----X--X--------------------X--X--------XXXX----------------
---X-oo?-oo?-----oo--------------oo------E---oo--oo?-----oo----------oo?-E-------E---E---oo?---------E-------oo--oo--oo--oo------oo?-----E-------------------------------oo------oo?-----E----------BBBB
--XXo?M-o?M-----o--o------------o--o----B?M?o--oo?M-----o--o--------o?M-B?M?----B?M?B?M?o?M---------B?M?----o--oo--oo--oo--o----o?M-----B?M?----------------------------o--o----o?M-----B?M?--------B--B
-XXX-o-B-o-B-------------------------------------o-B-----------------o-B-----------------o-B-------------------------------------o-B---------------------------------------------o-B----------------B-EB
XXXX------------X--X------------X--X--------X--X--------X--X------------------------------------------------X--XX--XX--XX--X--------------------------------------------X--X------------------------BBBv
----BBBB---------------------oo--oo--oo?-oo--E-------------------E------BBBB-----oo?----BBBB-oo?-------------oo?-------------E---E---E---------------oo?-oo?-----oo-BBBB---------oo--oo--oo?-oo--oo--oof
----B--B--------------------o--oo--oo?M-o--oB?M?----------------B?M?----B--B----o?M-----B--Bo?M-------------o?M-------------B?M?B?M?B?M?------------o?M-o?M-----o--oB--B--------o--oo--oo?M-o--oo--oo?Mf
----B-EB-----------------------------o-B--------------------------------B-EB-----o-B----B-EB-o-B-------------o-B-------------------------------------o-B-o-B--------B-EB-----------------o-B---------o-f
----BBBB--------------------X--XX--X----X--X----------------------------BBBB------------BBBB--------------------------------------------------------------------X--XBBBB--------X--XX--X----X--XX--X---f
-T------BBBB-T---E-------E-----X-----oo----X-T---E--BBBB-E--BBBB----BBBB-------X-oo--E-------T---E---oo------T---E---T--BBBB-T--BBBB-----T--BBBB-E-------T--BBBB---X----BBBB-E---------X-----E-----X-oof
-|oT--E-B--B-|oTB?M?--E-B?M?--XX--E-o--o--XX-|oTB?M?B--BB?M?B--B--E-B--B--E---XXo--oB?M?--E--|oTB?M?o--o--E--|oTB?M?-|oTB--B-|oTB--B--E--|oTB--BB?M?--E--|oTB--B--XX--E-B--BB?M?--E---XX--E-B?M?--XXo--f
m|-|----B-EB-|-|-------------XXX---------XXX-|-|----B-EB----B-EB----B-EB-----XXX-------------|-|-------------|-|-----|-|B-EB-|-|B-EB-----|-|B-EB---------|-|B-EB-XXX----B-EB---------XXX---------XXX---X
XXXXXXXXBBBBXXXX----XXXX----XXXXXXXXX--XXXXXXXXX----BBBB----BBBBXXXXBBBBXXXXXXXXX--X----XXXXXXXX----X--XXXXXXXXX----XXXXBBBBXXXXBBBBXXXXXXXXBBBB----XXXXXXXXBBBBXXXXXXXXBBBB----XXXXXXXXXXXX----XXXXX--X
