-?o?---X----BBBB-?o?-----------------------X-----E-------E-------?o?----BBBB-?o?---X-oo----------------------oo--E-------?o?---------oo------------------------------oo--oo--?o?-oo--?o?---------?o?-oo-
o-Mo--XX----B--Bo-Mo----------------------XX----B?M?----B?M?----o-Mo----B--Bo-Mo--XXo--o--------------------o--oB?M?----o-Mo--------o--o----------------------------o--oo--oo-Moo--oo-Mo--------o-Moo--o
-o---XXX----B-EB-o-----------------------XXX---------------------o------B-EB-o---XXX-------------------------------------o---------------------------------------------------o-------o-----------o------
----XXXX----BBBB------------------------XXXX----------------------------BBBB----XXXXX--X--------------------X--X--------------------X--X----------------------------X--XX--X----X--X----------------X--X
-oo------oo------oo------E---------X-oo---B--E---E---------------?o?-----?o?-oo--oo--?o?--B--E-----X-----oo------?o?-E---?o?-E-------E---E-------------------------------?o?-E----B-BBBB-----?o?-----?o?
o--o----o--o----o--o----B?M?------XXo--o----B?M?B?M?------------o-Mo----o-Moo--oo--oo-Mo----B?M?--XX----o--o----o-MoB?M?o-MoB?M?----B?M?B?M?----------------------------o-MoB?M?----B--B----o-Mo----o-Mo
---------------------------------XXX-----------------------------o-------o-----------o-----------XXX-------------o-------o-----------------------------------------------o----------B-EB-----o-------o--
X--X----X--X----X--X------------XXXXX--XXXXX--------------------------------X--XX--X----XXXX----XXXX----X--X--------------------------------------------------------------------XXXXBBBB---------------v
-------X-oo--E-------E----------------------BBBB---------oo--------X---X-oo------?o?-E---?o?---------E---?o?-E-------------------E---?o?-----oo----------?o?-oo----X-E---oo--------------oo------------f
------XXo--oB?M?----B?M?--------------------B--B--------o--o------XX--XXo--o----o-MoB?M?o-Mo--------B?M?o-MoB?M?----------------B?M?o-Mo----o--o--------o-Moo--o--XXB?M?o--o------------o--o----------Ef
-----XXX------------------------------------B-EB-----------------XXX-XXX---------o-------o---------------o---------------------------o-------------------o-------XXX-----------------------------------f
----XXXXX--X--------------------------------BBBB--------X--X----XXXXXXXXX--X----------------------------------------------------------------X--X------------X--XXXXX----X--X------------X--X--------XXXf
-----T-----X-----T---T-----X-E---T---E---E-------E---------X-E---------X-----E---oo------T---E--BBBB-----E---?o?-E---oo-BBBB-E-------T---E-------E---oo--------X-----------X-E---oo--E-------E--BBBB-?of
-----|oT--XX--E--|oT-|oT--XXB?M?-|oTB?M?B?M?--E-B?M?--E---XXB?M?--E---XX--E-B?M?o--o--E--|oTB?M?B--B--E-B?M?o-MoB?M?o--oB--BB?M?--E--|oTB?M?--E-B?M?o--o--E---XX--E---E---XXB?M?o--oB?M?--E-B?M?B--Bo-Mf
m----|-|-XXX-----|-|-|-|-XXX-----|-|---------------------XXX---------XXX-----------------|-|----B-EB---------o----------B-EB---------|-|---------------------XXX---------XXX--------------------B-EB-o-X
XX--XXXXXXXXXXXXXXXXXXXXXXXX----XXXX--------XXXX----XXXXXXXX----XXXXXXXXXXXX----X--XXXXXXXXX----BBBBXXXX------------X--XBBBB----XXXXXXXX----XXXX----X--XXXXXXXXXXXXXXXXXXXXX----X--X----XXXX----BBBB---X
